{
    "width": 100,
    "height": 80,
    "spawnpos": [25, 25],
    "mapgrid": [
        "....................................................................................................",
        "....................................................................................................",
        "....................................................................................................",
        "....................................................................................................",
        "....................................................................................................",
        "....................................................................................................",
        "....................................................................................................",
        "....................................................................................................",
        "....................................................................................................",
        "....................................................................................................",
        "....................................................................................................",
        "....................................................................................................",
        "....................................................................................................",
        "....................................................................................................",
        "....................................................................................................",
        "....................................................................................................",
        "....................................................................................................",
        "....................................................................................................",
        "...................................................WWWWWWWWWWWWWWWWWWWWWW...........................",
        "...................................................WFFFFFFFFFFFFFFFFFFFFW...........................",
        "...................WWWW.....WWWW...................WFFFFFFFFFFFFFFFFFFFFW...........................",
        "...................WFFFFFFFFFFFW...................WFFFFFFFFFFFFFFFFFFFFW...........................",
        "...................WFFFFFFFFFFFWWWWWWWWWWWWWWWWWWWWWFFFFFFFFFFFFFFFFFFFFW...........................",
        "....................FFFFFFFFFFFFFFFFFFFFFFFFFFFFFFFFFFFFFFFFFFFFFFFFFFFFW...........................",
        "....................FFFFFFFFFFFFFFFFFFFFFFFFFFFFFFFFFFFFFFFFFFFFFFFFFFFFW...........................",
        "....................FFFFFFFFFFFFFFFFFFFFFFFFFFFFFFFFFFFFFFFFFFFFFFFFFFFFW...........................",
        "...................WFFFFFFFFFFFWWWWWWWWWWWWWWWWWWWWWFFFFFFFFFFFFFFFFFFFFW...........................",
        "...................WFFFFFFFFFFFW...................WFFFFFFFFFFFFFFFFFFFFW...........................",
        "...................WWWW.....WWWW...................WFFFFFFFFFFFFFFFFFFFFW...........................",
        "...................................................WFFFFFFFFFFFFFFFFFFFFW...........................",
        "...................................................WWWWWWWWWWWWWWWWWWWWWW...........................",
        "....................................................................................................",
        "....................................................................................................",
        "....................................................................................................",
        "....................................................................................................",
        "....................................................................................................",
        "....................................................................................................",
        "....................................................................................................",
        "....................................................................................................",
        "....................................................................................................",
        "....................................................................................................",
        "....................................................................................................",
        "....................................................................................................",
        "....................................................................................................",
        "....................................................................................................",
        "....................................................................................................",
        "....................................................................................................",
        "....................................................................................................",
        "....................................................................................................",
        "....................................................................................................",
        "....................................................................................................",
        "....................................................................................................",
        "....................................................................................................",
        "....................................................................................................",
        "....................................................................................................",
        "....................................................................................................",
        "....................................................................................................",
        "....................................................................................................",
        "....................................................................................................",
        "....................................................................................................",
        "....................................................................................................",
        "....................................................................................................",
        "....................................................................................................",
        "....................................................................................................",
        "....................................................................................................",
        "....................................................................................................",
        "....................................................................................................",
        "....................................................................................................",
        "....................................................................................................",
        "....................................................................................................",
        "....................................................................................................",
        "....................................................................................................",
        "....................................................................................................",
        "....................................................................................................",
        "....................................................................................................",
        "....................................................................................................",
        "....................................................................................................",
        "....................................................................................................",
        "....................................................................................................",
        "...................................................................................................."
    ],

    "tile_id": {
        "grass": ".",
        "wall": "W",
        "floor": "F"
    } 
}