{
    "width": 100,
    "height": 80,
    "spawnpos": [25, 25],
    "mapgrid": [
        "....................................................................................................",
        "....................................................................................................",
        "....................................................................................................",
        "....................................................................................................",
        "....................................................................................................",
        "....................................................................................................",
        "....................................................................................................",
        "....................................................................................................",
        "....................................................................................................",
        "....................................................................................................",
        "....................................................................................................",
        "....................................................................................................",
        "....................................................................................................",
        "....................................................................................................",
        "....................................................................................................",
        "....................................................................................................",
        "....................................................................................................",
        "....................................................................................................",
        "...................................................WWWWWWWWWWWWWWWWWWWWWW...........................",
        "...................................................W....................W...........................",
        "...................WWWW.....WWWW...................W....................W...........................",
        "...................W...........W...................W....................W...........................",
        "...................W...........WWWWWWWWWWWWWWWWWWWWW....................W...........................",
        "........................................................................W...........................",
        "........................................................................W...........................",
        "........................................................................W...........................",
        "...................W...........WWWWWWWWWWWWWWWWWWWWW....................W...........................",
        "...................W...........W...................W....................W...........................",
        "...................WWWW.....WWWW...................W....................W...........................",
        "...................................................W....................W...........................",
        "...................................................WWWWWWWWWWWWWWWWWWWWWW...........................",
        "....................................................................................................",
        "....................................................................................................",
        "....................................................................................................",
        "....................................................................................................",
        "....................................................................................................",
        "....................................................................................................",
        "....................................................................................................",
        "....................................................................................................",
        "....................................................................................................",
        "....................................................................................................",
        "....................................................................................................",
        "....................................................................................................",
        "....................................................................................................",
        "....................................................................................................",
        "....................................................................................................",
        "....................................................................................................",
        "....................................................................................................",
        "....................................................................................................",
        "....................................................................................................",
        "....................................................................................................",
        "....................................................................................................",
        "....................................................................................................",
        "....................................................................................................",
        "....................................................................................................",
        "....................................................................................................",
        "....................................................................................................",
        "....................................................................................................",
        "....................................................................................................",
        "....................................................................................................",
        "....................................................................................................",
        "....................................................................................................",
        "....................................................................................................",
        "....................................................................................................",
        "....................................................................................................",
        "....................................................................................................",
        "....................................................................................................",
        "....................................................................................................",
        "....................................................................................................",
        "....................................................................................................",
        "....................................................................................................",
        "....................................................................................................",
        "....................................................................................................",
        "....................................................................................................",
        "....................................................................................................",
        "....................................................................................................",
        "....................................................................................................",
        "....................................................................................................",
        "....................................................................................................",
        "...................................................................................................."
    ],

    "tile_id": {
        "grass": ".",
        "wall": "W"
    } 
}