{
    "width": 100,
    "height": 80,
    "spawnpos": [25, 25],
    "mapgrid": [
        "....................................................................................................",
        "....................................................................................................",
        "....................................................................................................",
        "....................................................................................................",
        "....................................................................................................",
        "....................................................................................................",
        "....................................................................................................",
        "....................................................................................................",
        "....................................................................................................",
        "....................................................................................................",
        "....................................................................................................",
        "....................................................................................................",
        "....................................................................................................",
        "....................................................................................................",
        "....................................................................................................",
        "....................................................................................................",
        "....................................................................................................",
        "....................................................................................................",
        "....................................................................................................",
        "....................................................................................................",
        "...................WWWW.....WWWW....................................................................",
        "...................W...........W..................................................W.................",
        "...................W...........W....................................................................",
        "....................................................................................................",
        "....................................................................................................",
        "....................................................................................................",
        "...................W...........W....................................................................",
        "...................W...........W....................................................................",
        "...................WWWW.....WWWW....................................................................",
        "....................................................................................................",
        "....................................................................................................",
        "....................................................................................................",
        "....................................................................................................",
        "....................................................................................................",
        "....................................................................................................",
        "....................................................................................................",
        "....................................................................................................",
        "....................................................................................................",
        "....................................................................................................",
        "....................................................................................................",
        "....................................................................................................",
        "....................................................................................................",
        "....................................................................................................",
        "....................................................................................................",
        "....................................................................................................",
        "....................................................................................................",
        "....................................................................................................",
        "....................................................................................................",
        "....................................................................................................",
        "....................................................................................................",
        "....................................................................................................",
        "....................................................................................................",
        "....................................................................................................",
        "....................................................................................................",
        "....................................................................................................",
        "....................................................................................................",
        "....................................................................................................",
        "....................................................................................................",
        "....................................................................................................",
        "....................................................................................................",
        "....................................................................................................",
        "....................................................................................................",
        "....................................................................................................",
        "....................................................................................................",
        "....................................................................................................",
        "....................................................................................................",
        "....................................................................................................",
        "....................................................................................................",
        "....................................................................................................",
        "....................................................................................................",
        "....................................................................................................",
        "....................................................................................................",
        "....................................................................................................",
        "....................................................................................................",
        "....................................................................................................",
        "....................................................................................................",
        "....................................................................................................",
        "....................................................................................................",
        "....................................................................................................",
        "WWWWWWWWWWWWWWWWWWWWWWWWWWWWWWWWWWWWWWWWWWWWWWWWWWWWWWWWWWWWWWWWWWWWWWWWWWWWWWWWWWWWWWWWWWWWWWWWWWWW"
    ],

    "tile_id": {
        "grass": ".",
        "wall": "W"
    } 
}